@@172809	##	fo
&gt;	&gt;/-	fo
Reinhard	reinhard	np1
Heydrich	heydrich	np1
,	,	y
Reich	reich	np1
's	's	ge
Protector	protector	nn1
in	in	ii
Bohemia	bohemia	np1
and	and	cc
Moravia	moravia	np1
,	,	y
whom	whom	pnqo
the	the	at
Czechs	czech	nn2
think	think	vv0
of	of	io
as	as	csa
Reznik	reznik	np1	
(	(	y
Butcher	butcher	np1
)	)	y
,	,	y
last	last	md
week	week	nnt1
ordered	order	vvd_vvn
the	the	at
execution	execution	nn1
of	of	io
five	five	mc
butchers	butchers	nn
accused	accuse	vvn_vvd
of	of	io
the	the	at
"	"	"
illegal	illegal	jj
sale	sale	nn1
"	"	"
of	of	io
hogs	hog	nn2
,	,	y
cattle	cattle	nn2
and	and	cc
other	other	jj
animals	animal	nn2
.	.	y
<P>	<p>	null	
&gt;In	&gt;in	fo	
London	london	np1
the	the	at
Polish	polish	jj
Government-in-Exile	government-in-exile	np1	
reported	report	vvd
that	that	cst_dd1
112,000	112,000	mc
Poles	pole	nn2
have	have	vh0
been	be	vbn
hanged	hang	vvn
or	or	cc
shot	shoot	vvd_vvn_nn1
by	by	ii
Nazi	nazi	jj
death	death	nn1
squads	squad	nn2
.	.	y
<P>	<p>	null	
&gt;The	&gt;the	fo	
Yugoslav	yugoslav	jj
Government-in-Exile	government-in-exile	np1	
charged	charge	vvd
that	that	cst
Hitler	hitler	np1
plans	plan	vvz
the	the	at
extermination	extermination	nn1
of	of	io
the	the	at
Serbian	serbian	jj
race	race	nn1
,	,	y
that	that	cst_dd1
more	more	dar
than	than	csn
300,000	300,000	mc
men	man	nn2
,	,	y
women	woman	nn2
and	and	cc
children	child	nn2
already	already	rr
have	have	vh0
been	be	vbn
slaughtered	slaughter	vvn
.	.	y
<P>	<p>	null	
&gt;In	&gt;in	fo	
Belgium	belgium	np1
rats	rat	nn2
were	be	vbdr
butchered	butcher	vvn@_jj@
,	,	y
sold	sell	vvn_vvd
for	for	if
20	20	mc
francs	franc	nnu2
in	in	ii
markets	market	nn2
.	.	y
