@@373682	##	fo
Vox	vox	np1
Web	web	nn1
Last	last	md
week	week	nnt1
we	we	ppis2
asked	ask	vvd
,	,	y
"	"	"
Do	do	vd0
you	you	ppy
think	think	vvi
a	a	at1
better	better	jjr
understanding	understanding	nn1
of	of	io
their	their	appge
religious	religious	jj
bond	bond	nn1
might	might	vm
make	make	vvi
Jews	jew	nn2
,	,	y
Muslims	muslim	nn2
and	and	cc
Christians	christian	nn2
less	less	rgr
prone	prone	jj
to	to	to
conflict	conflict	vvi
?	?	y
"	"	"
<P>	<p>	null	
The	the	at
Results	result	nn2
:	:	y
<P>	<p>	null	
16.8%	16.8%	fo
Yes	yes	uh
83.2%	83.2%	fo	
No	no	uh_at
<P>	<p>	null	
BACK	back	nn1
ISSUES	issue	vvz@	
9/11	9/11	mf
Memorial	memorial	nn1
Edition	edition	nn1
