@@364168	##	fo
In	in	ii
the	the	at
pages	page	nn2
following	follow	vvg_ii@
the	the	at
Arts	art	nn2
section	section	nn1_vv0%
,	,	y
TIME	time	nnt1
reports	report	vvz_nn2
on	on	ii
issues	issue	nn2
affecting	affect	vvg
women	woman	nn2
and	and	cc
their	their	appge
families	family	nn2
<P>	<p>	null	
 -- 	--	zz
Parenting	parenting	nn1
2.0	2.0	mc
<P>	<p>	null	
Moms	mom	nn2
get	get	vv0
busy	busy	jj
blogging	blogging	nn1@_jj@
,	,	y
sharing	share	vvg
photos	photo	nn2
and	and	cc
commiserating	commiserate	vvg
online	online	rr_jj
<P>	<p>	null	
 -- 	--	nn1
Smells	smell	vvz
like	like	ii
Home	home	nn1
<P>	<p>	null	
New	new	jj
products	product	nn2
offer	offer	vv0
aromatherapy	aromatherapy	nn1
while	while	cs
you	you	ppy
clean	clean	vv0@_jj
,	,	y
but	but	ccb
they	they	pphs2
will	will	vm
cost	cost	vvi
you	you	ppy
<P>	<p>	null	
 -- 	--	zz
Ashamed	ashamed	jj
to	to	ii
Sneeze	sneeze	nn1
<P>	<p>	null	
Stress	stress	nn1_vv0@
incontinence	incontinence	nn1
afflicts	afflict	vvz
1	1	mc1
in	in	ii
5	5	mc
women	woman	nn2
over	over	rg
50	50	mc
.	.	y
Most	most	dat
can	can	vm
be	be	vbi
helped	help	vvn
<P>	<p>	null	
 -- 	--	zz
Sibling	sibling	nn1
Rivalry	rivalry	nn1
<P>	<p>	null	
Author	author	nn1_vv0%
Dalton	dalton	np1
Conley	conley	np1
explains	explain	vvz
why	why	rrq
inequality	inequality	nn1
begins	begin	vvz
at	at	ii
home	home	nn1
