@@369503	##	fo
We	we	ppis2
realize	realize	vv0
that	that	cst
after	after	ii
reading	read	vvg
this	this	dd1
week	week	nnt1
's	's	ge
Cover	cover	nn1
Story	story	nn1
,	,	y
you	you	ppy
may	may	vm
want	want	vvi
to	to	to
do	do	vdi
something	something	pn1
.	.	y
Working	work	vvg
with	with	iw
