@@381380	##	fo
Post-Monica	post-monica	jj	
,	,	y
the	the	at
female	female	jj_nn1
intern	intern	nn1
in	in	ii
the	the	at
nation	nation	nn1
's	's	ge
capital	capital	nn1
has	have	vhz
a	a	at1
reputation	reputation	nn1
that	that	cst_dd1
's	be	vbz
part	part	rr%_nn1
Catholic	catholic	jj_nn1
schoolgirl	schoolgirl	nn1
,	,	y
part	part	nn1
Paris	paris	np1
Hilton	hilton	np1
:	:	y
sexy	sexy	jj
,	,	y
scantily	scantily	rr
clad	clad	vvn
and	and	cc
technically	technically	rr
off-limits	off-limits	jj
,	,	y
but	but	ccb
too	too	rg
clueless	clueless	jj
to	to	to
know	know	vvi
better	better	rrr_jjr
.	.	y
Such	such	da
stereotyping	stereotyping	nn1
is	be	vbz
n't	n't	xx
fair	fair	jj_rr@
to	to	ii
most	most	dat
of	of	io
the	the	at
ambitious	ambitious	jj
young	young	jj
women	woman	nn2
who	who	pnqs
flock	flock	vv0
to	to	ii
Washington	washington	np1
each	each	dd1
year	year	nnt1
(	(	y
20,000	20,000	mc
interns	intern	nn2
arrive	arrive	vv0
every	every	at1
summer	summer	nnt1
,	,	y
counting	count	vvg
the	the	at
boys	boy	nn2
)	)	y
.	.	y
But	but	ccb
the	the	at
visiting	visiting	jj
vixen	vixen	nn1
's	's	ge
midriff-baring	midriff-baring	nn1_jj	
,	,	y
miniskirted	miniskirted	vvd_jj@	
image	image	nn1
rings	ring	vvz_nn2
true	true	jj_rr%_vv0%
enough	enough	rr_dd
to	to	to
have	have	vhi
prompted	prompt	vvn
a	a	at1
neologism	neologism	nn1
 -- 	--	nn1
SKINTERNS	skinterns	vvz_nn2	
 -- 	--	nn1_jj
as	as	ii31
well	well	ii32
as	as	ii33
efforts	effort	nn2
to	to	to
make	make	vvi
young	young	jj
women	woman	nn2
more	more	rgr
presentable	presentable	jj
in	in	ii
Capitol	capitol	np1
Hill	hill	np1
's	's	ge
still	still	rr_jj@
starchy	starchy	jj
environment	environment	nn1
.	.	y
One	one	mc1
intern	intern	nn1
coordinator	coordinator	nn1
marks	mark	vvz@_nn2
every	every	at1
day	day	nnt1
's	's	ge
schedule	schedule	nn1
to	to	to
indicate	indicate	vvi
what	what	ddq
level	level	nn1
of	of	io
formality	formality	nn1
is	be	vbz
required	require	vvn
from	from	ii
D	d	zz1_np1@
for	for	if
dressy	dressy	nn1_jj
to	to	ii
VC	vc	nn1
for	for	if
very	very	rg
casual	casual	jj
.	.	y
Take	take	vv0
note	note	nn1_vv0
:	:	y
there	there	ex
's	be	vbz
no	no	at
SC	sc	fo
for	for	if
scantily	scantily	rr
clad	clad	vvn
.	.	y
